&...#.......................................#.....
....#.......................................#.....
............................................#.....
....#.......................................#.....
.#######....................................#.....
.#..#.......................................#.....
.#.##.......................................#.....
.#..#.......................................#.....
.##.#.......................................#.....
.#..........................................#.....
.#..........................................#.....
.#..........................................#.....
.#..........................................#.....
.#..........................................#.....
.#..........................................#.....
.#..........................................#.....
.#..........................................#.....
.#..........................................#.....
.################################################
..................................................
