

















▓▓▓▓▓▓▓▓▓▓▓▓▓▓▓▓▓▓▓▓▓▓▓▓▓▓▓▓▓▓▓▓▓▓▓▓▓▓▓▓▓▓▓▓▓▓▓▓▓▓▓▓▓▓▓▓▓▓▓▓▓▓▓▓▓
-----------------------------▓▓@ . . . # . . . . . . . . . . . . 
-----------------------------▓▓. . . . # . . . . . . . . . . . . 
-----------------------------▓▓. . . . . . . . . . . . . . . . . 
-----------------------------▓▓. . . . # . . . . . . . . . . . . 
-----------------------------▓▓# # . # # . . . . . . . . . . . . 
-----------------------------▓▓. . . . . . . . . . . . . . . . . 
-----------------------------▓▓. . . . . . . . . . . . . . . . . 
-----------------------------▓▓. . . . . . . . . . . . . . . . . 
-----------------------------▓▓. . . . . . . . . . . . . . . . . 
-----------------------------▓▓. . . . . . . . . . . . . . . . . 
-----------------------------▓▓. . . . . . . . . . . . . . . . . 
-----------------------------▓▓. . . . . . . . . . . . . . . . . 
-----------------------------▓▓. . . . . . . . . . . . . . . . . 
-----------------------------▓▓. . . . . . . . . . . . . . . . . 
-----------------------------▓▓. . . . . . . . . . . . . . . . . 
-----------------------------▓▓. . . . . . . . . . . . . . . . . 
-----------------------------▓▓. . . . . . . . . . . . . . . . . 



