














                          ▓▓▓▓▓▓▓▓▓▓▓▓▓▓▓▓▓▓▓▓▓▓▓▓▓▓▓▓▓▓▓▓▓▓▓▓▓▓
                          ▓▓▓& . . . # . . . . . . . . . . . . 
                          ▓▓▓. @ . . # . . . . . . . . . . . . 
                          ▓▓▓. . . . . . . . . . . . . . . . . 
                          ▓▓▓. . . . # . . . . . . . . . . . . 
                          ▓▓▓. # # # # . . . . . . . . . . . . 
                          ▓▓▓. # . . . . . . . . . . . . . . . 
                          ▓▓▓. # . . . . . . . . . . . . . . . 
                          ▓▓▓. # . . . . . . . . . . . . . . . 
                          ▓▓▓. # . . . . . . . . . . . . . . . 
                          ▓▓▓. # . . . . . . . . . . . . . . . 
                          ▓▓▓. # . . . . . . . . . . . . . . . 
                          ▓▓▓. # . . . . . . . . . . . . . . . 
                          ▓▓▓. # . . . . . . . . . . . . . . . 
                          ▓▓▓. # . . . . . . . . . . . . . . . 
                          ▓▓▓. # . . . . . . . . . . . . .
