
. . . . . . . . . . . . . . . . . . . . . . . . . . . . . ║ . . 
. . . . . . . . . . . . . . . . . . . . . . . . . . . . . ║ . . 
. . . . . . . . . . . . . . . . . . . . . . . . . . . . . ║ . . 
. . . . . . . . . . . . . . . . . . . . . . . . . . . . . ║ . . 
. . . . . . . . . . . . . . . . . . . . . . . . . . . . . ║ . . 
. . . . . . . . . . . . . . . . . . . . . . . . . . . . . ║ . . 
. . . . . . . . . . . . . . . . . . . . . . . . . . . . . ║ . . 
. . . . . . . . . . . . . . . . . . . . . . . . . . . . . ║ . . 
. . . . . . . . . . . . . . . . . . . . . . . . . . . . . ║ . . 
. . . . . . . . . . . . . . . . . . . . . . . . . . . . . ║ . . 
. . . . . . . . . . . . . . . . . . . . . . . . . . . . . ║ . . 
. . . . . . . . . . . . . . . . . . . . . . . . . . . . . ║ . . 
. . . . . . . . . . . . . . . . . . . . . . . . . . . . . ║ . . 
. . . . . . . . . . . . . . . . . . . . . . . . . . . . . ║ . . 
. . . . . . . . . . . . . . . . . . . . . . . . . . . . . ║ . . 
. . . . . . . . . . . . . . . . . . . . . . . . . . . . . ║ . . 
═ ═ ═ ═ ═ ═ ═ ═ ═ ═ ═ ═ ═ ═ ═ ═ ═ ═ ═ ═ ═ ═ ═ ═ ═ ═ ═ ═ ═ ╩ ═ ═ 
. . . . . . . . . . . . . . . . @ . . . . . . . . . . . . . . . 
▓▓▓▓▓▓▓▓▓▓▓▓▓▓▓▓▓▓▓▓▓▓▓▓▓▓▓▓▓▓▓▓▓▓▓▓▓▓▓▓▓▓▓▓▓▓▓▓▓▓▓▓▓▓▓▓▓▓▓▓▓▓▓▓▓











